NO ./utils/pictures/stone.xpm
SO ./utils/pictures/deco.xpm

EA ./utils/pictures/glass.xpm
F 0,255,1
C 255,45,145
R 700 2000
WE ./utils/pictures/brick.xpm

11111111111111111
10000000001000001
10000020001110001
10000000201000001
10000000111020001
10020000S00000001
10000000002000001
11111111111111111