NO ./utils/pictures/stone.xpm
SO ./utils/pictures/deco.xpm

EA ./utils/pictures/glass.xpm
F 0,255,1
C 255,45,145
R 600 600
WE ./utils/pictures/brick.xpm

11111111111111111
10000000000000001
10000020000000001
10000000200000001
10000000000000001
10020000S00000001
10000000000000001
11111111111111111